||||||||    |||||||       |       ||      ||
   ||       ||           | |      |||     ||
   ||       ||          |   |     || |    ||
   ||       |||||      |||||||    ||  |   ||
   ||       ||        |       |   ||   |  ||
|  ||       ||       |         |  ||    | ||
 |||        ||||||  |           | ||     |||